111111111111111111111111111111111111111111111111111111111111111111111111111111111111111111111111111111111111111111111111111111111111111111111111111111111111111111111111111
111111111111111111111111111111111111111111111111111111111111111111111111111111111111111111111111111111111111111111110000000000000000000000000000000000010000000`11111111111
111111111111111111111111111111111111111111111111111111111111111111111111111111111111111111111111111111111111111111110A000000000000000000000000000000000D0000000`11111111111
111111111111111111111111111111111111111111111111111111111111111111111111111111111111111111111111111111111111111111110000000000000000000000000000000000000000000`11111111111
111111111111111111111111111111111111111111111111111111111111111111111111111111111111111111111111111111111111111111110000000000000011100001100000000011111111000`11111111111
1111111111111111111111111111111111111111111111111111111111111111111111111111111111111111111111111111111111111111111111110000000000000000010000001100Y0010000000`11111111111
111111111111111111111111111111111111111111111111111111111111111111111111111111111111111111111111111111111111111111110000000000110000000101000000000000010000000`11111111111
111111111111111111111111111111111111111111111111111111111111111111111111111111111111111111111111111111111111111111110000000000000000000001001100000000010111111`11111111111
11111111111111111111111111111111111111111111111111111111111111111111111111111111111111111111111111111111111111111111000000110000000000000100000>000000010000000`11111111111
111111111111111111111111111111111111111111111111111111111111111111111111111111111111111111111111111111111111111111110000000000000000000011000000000000:10000000^11111111111
1111111111111111111111111111111111111111111111111111111111111111111111111111111111111111111111111111111111111111111100000000000000000000Y11100000000Z0010000000011111111111
111111111111111111111111111111111111111111111111111111111111111111111111111111111111111111111111111111111111111111111111111111111110000000011111111111111111111`11111111111
111111111111111111111111111111111111111111111111111111111111111111111111111111111111111111111111111111111111111111111111111111111111000000001111111111111111111`11111111111
000000000000000000000000000000001000111111111111111111111111111111110000000000000000000000000000000000000000001000000010000000000001100000000000011111111111111`11111111111
00000000000000000000000000000000T00000111111111111111111111111110000000000000000000000000000000000000000000000T0000000108000000000001100Z0000000000111111111111`11111111111
00000000000000000000000000000000000000010011111111111111111110000000000000000000=000000000000000000000000000000000000011100000000000011111100000000011111111111`11111111111
00000000000000000000000000000000000000010000111111111111110000000000000000000000111V111111100000000000000000000000000000111000000000000000011110000000000000000`11111111111
00000000000000000000000000000000000000010000000O00000000000000000000000000000000000V000000000000000000000000000000000000000010000000000000000000000?00000000090`11111111111
00000000000000000000000000000000000000010000000000000000000000000000000000000000000V000000000000000000000000000000000000000011000000000000000000000000000000000`11111111111
00000000000000000000000?0000000000000001000?000000000000000000000000000000000000000V0000000000000000000?0000000000000000000000000000000000000011111111111111111`11111111111
00000000000000000000000000000000000000010000000000000000000000000000000000000000000V0000000000111100000000000000000000000000000010000<0000001111111111111111111`11111111111
000000000000000000000000000000000000000D0000000000000000000001000000000000000000000V000000000000000000000000000000000000000000011100000000111111111111111111111`11111111111
0000000000000100000000000000W000000000000000000000000000000011100000000000000000000V00000000000000000000000000W000000000000000111110000011111111111111111111111`11111111111
111111111111111111111111111111111111111111111111111111111111111111111111111111111111111111111111111111111111111111111111111111111111111111111111111111111111111111111111111
111111111111111111111111111111111111111111111111111111111111111111111111111111111111111111111111111111111111111111111111111111111111111111111111111111111111111111111111111