1111111111111111111111111111111111111111111111111111111111111111111111111111111111`1111111111111111111111111111111111111111111111111111111111111111111111111111111111111111
100000D000000000000000000000100000011111111111111111111111111111111111111111111000`111111100111111111111111111111111111111111111111111111111111111111111111111111111111111`
1008000000000000000000000000T00000011111111111111111111111111111111111111111111000`1111111000N0000001111111111111111111111111111111111111111111111111111111111111111111111`
1000001100100000001000000000000000011111111111111111111111111111111111111111111000`111111100000000001111111111111111111111111111111111111111111111111111111111111111111111`
1100011100100000001000000000000000011111111111111111111111111111111111111111111000`1111111V1111110001111111111111111111111111111111111111111111111111111111111111111111111`
10000000N00000000010000000000000000111111111111111111111111111111T1111111111111000`1111111V1111110001111111111111111111111111111111111111111111111111111111111111111111111`
1000000000000W00001001000000000000011111111111111111111111111111000011111111111000`1111111V1111110001111111111111111111111111111111111111111111111111111111111111111111111`
10000001111001111110000010000000000111111111111111111111111111000000000000000D0000^1111111V1111110000000011111111111111111111111111111111111111111111111111111111111111111`
100000110000011111110000000000000001111111000000000000000100010000000<00000000000001111110V000000000000>011111111111111111111111111111111111111111111111111111111111111111`
00000001?00000000D000000000000000000D00000000000000000<0010?0D0000000001111V11111111111110V0000A00000000011111111111111111111111111111111111111111111111111111111111111111`
0000000100000000000000000X00000000000000000000000000000001:0000000000011111V0000000111111111100000001111111111111111111111111111111111111111111111111111111111111111111111`
111111111111111111111111111111111111111111111110000011111111111000000011000V0000000000000000000010001111111111111111111111111111111111111111111111111111111111111111111111`
11111111111111111111111111111111111111111111111111000111Y110000000000111000V0000000000000000001110000000000111111111111111111111111111111111111111111111111111111111111111`
111111111111111111111111111110000111111111111100010000000000000X00001100000V00000000000000000111000000000?0111111111111111111111111111111111111111111111111111111111111111`
1111110000000000000000000000D0000000000000000D0?0110?0000000011111111T0000111J00000J0000011V111000000111000111111111111111111111111111111111111111111111111111111111111111`
111111000000000000N00A000000000000000000000000009110000000000001110000000000000000000000000V011000000111111111111111111111111111111111111111111111111111111111111111111111`
1111110000000000000000000001110000111111111111111111000000000001100000000000000000000000000V000000000111111111111111111111111111111111111111111111111111111111111111111111`
111111000V1111110111111111111100000000011111111111111111Z1111000000000000000000000000000000V000000000111111111111111111111111111111111111111111111111111111111111111111111`
111111000V00001000000000000N000000000000110000000000001111100000000000000000001000000000000V001111111100011111111111111111111111111111111111111111111111111111111111111111`
111111000V0000100000000000000000000000001100000000000000000000110000000000000111111111111111111111100000011111111111111111111111111111111111111111111111111111111111111111`
111111000V00=0111111111011111101110000001100000A0000=00000000111100000000001111000111111000111O00000000>011111111111111111111111111111111111111111111111111111111111111111`
100000000V0000000000000000000100000000000D00000000000000000011111000000000000000000000D00?00000000000000011111111111111111111111111111111111111111111111111111111111111111`
1W0000000V0000000000000000000100000000000000000000000000011111111110X00W00000000000000000000000000000000011111111111111111111111111111111111111111111111111111111111111111`
111111111111111111111111111111111111111111111111111111111111111111111111111111111111111111111111111111111111111111111111111111111111111111111111111111111111111111111111111
111111111111111111111111111111111111111111111111111111111111111111111111111111111111111111111111111111111111111111111111111111111111111111111111111111111111111111111111111