111111111111111111111111111111111111111111111111111111111111111111111111111111111111111111111111111111111111111111111111111111111111111111111111111111111111111111111111111
11111111111111111111111111111111111111111111111111111111111111111111111111111111111111111111111111111111111111111111111111111110000000000000000000000000000000000010000000`
11111111111111111111111111111111111111111111111111111111111111111111111111111111111111111111111111111111111111111111111111111110A000000000000000000000000000000000D0000000`
11111111111111111111111111111111111111111111111111111111111111111111111111111111111111111111111111111111111111111111111111111110000000000000000000000000000000000000000000`
11111111111111111111111111111111111111111111111111111111111111111111111111111111111111111111111111111111111111111111111111111110000000000000001100001100000000011111000000`
111111111111111111111111111111111111111111111111111111111111111111111111111111111111111111111111111111111111111111111111111111111110000000000000000010000001100Y0010000000`
11111111111111111111111111111111111111111111111111111111111111111111111111111111111111111111111111111111111111111111111111111110000000000110000000101000000000000010000000`
11111111111111111111111111111111111111111111111111111111111111111111111111111111111111111111111111111111111111111111111111111110000000000000000000001001100000000010100000`
1111111111111111111111111111111111111111111111111111111111111111111111111111111111111111111111111111111111111111111111111111111000000110000000000000100000>000000010000000`
11111111111111111111111111111111111111111111111111111111111111111111111111111111111111111111111111111111111111111111111111111110000000000000000000011000000000000:10000000^
111111111111111111111111111111111111111111111111111111111111111111111111111111111111111111111111111111111111111111111111111111100000000000000000000Y11100000000Z00100000000
11111111111111111111111111111111111111111111111111111111111111111111111111111111111111111111111111111111111111111111111111111111111111111111110000000011111111111111111111`
11111111111111111111111111111111111111111111111111111111111111111111111111111111111111111111111111111111111111111111111111111111111111111111111000000001111111111111111111`
00000000000000000000000000000000100000011111111111111111111111111000000000000000000000000000000000000000070000000010000000000000010000000000001100000000000011111111111111`
00000000000000000000000000000000T0000001YY000111111111111100000000000000000000000000000000000000000000000700000000T00000000000000108000000000001100Z0000000000111111111111`
000000000000000000000000000000000000000100000000O0000000000000000000000000000000=000000000K0000000000000070000000000000000000000011100000000000011111100000000011111111111`
00000000000000000000000000000000000000010000000000000000000000000000000000000000111V11111110000000000000070000000000000000000000000010000000000000000011110000000000000000`
00000000000000000000000000000000000000010000000000000000000000000000000000000000000V00000000000000000000070000000000000000000000000000010000000000000000000000?00000000090`
00000000000000000000000000000000000000010000000000000000000000000000000000000000000V00000000000000000000070000000000000000000000000000011000000000000000000000000000000000`
00000000000000000000000?0000000000000001000?000000000000000000000000000000000000000V000000000000000000000?0000000000000000000000000000000000000000000000011111111111111111`
00000001111111111100000000000000000000010000000000000000000000000000000000000000000V000000000011110000000000000000000000000000000000000000010000<0000001111111111111111111`
000000000000000000000000000000000000000D0000000000000000000001000000000000000000000V00000000000000000000000000000000000000000000000000000011100000000111111111111111111111`
0000000000000000000000000000W00000000000ZZ00000000000000000011100000000000000000000V00000000000000000000000000W00000000000000000000000000111110000011111111111111111111111`
1111111J00000J0000011111111111111111111111111111111111111111111111111111111111111111111111111111111111111111111111111111111111111111111111111111111111111111111111111111111
111111111111111111111111111111111111111111111111111111111111111111111111111111111111111111111111111111111111111111111111111111111111111111111111111111111111111111111111111